1111111111111111111111
1P01C000000000000000C1
1001000000000100000001
1001001111111111111001
10011010001000C0000001
1001001000000000000001
1101001001111111111111
100100100000001C000001
1001001000000000000001
1000001111111001111101
1000001C01000000C10001
1001111001C10000010111
1001C00001110001110001
1C010000000000010000E1
1111111111111111111111