1111111111111111111111
1111111111111111111111
1001C000000P00000000C1
1C01000A00000100000001
10010011111111111110A1
10011010000000C0000001
1101001001111111111111
100100100000001C000001
1001011000000000000001
1000011111111001111101
1000001C01000000C10001
1001111001C10000010111
1001C00001110001110001
1C01000A0000000100A0E1
1111111111111111111111